/* XPM */
/* This file can be converted to EPS by the GROMACS program xpm2ps */
/* title:   "Mean smallest distance" */
/* legend:  "Distance (nm)" */
/* x-label: "Residue Index" */
/* y-label: "Residue Index" */
/* type:    "Continuous" */
static char *gromacs_xpm[] = {
"56 56   2 1",
"A  c #FFFFFF " /* "0" */,
"B  c #000000 " /* "0.8" */,
/* x-axis:  1 2 3 4 5 6 7 8 9 10 11 12 13 14 15 16 17 18 19 20 21 22 23 24 25 26 27 28 29 30 31 32 33 34 35 36 37 38 39 40 41 42 43 44 45 46 47 48 49 50 51 52 53 54 55 56 */
/* y-axis:  1 2 3 4 5 6 7 8 9 10 11 12 13 14 15 16 17 18 19 20 21 22 23 24 25 26 27 28 29 30 31 32 33 34 35 36 37 38 39 40 41 42 43 44 45 46 47 48 49 50 51 52 53 54 55 56 */
"BBBBBBBAAABBBBBBBBBBBBBBBBBBBBBBBBBBBBAAABBBBBBBBBBBBBAA",
"BBBBBBBABBBBBBBBBBBBBBBBBBBBBBBBBBBBBBBBAABBBBBBBBBBBAAA",
"BBBBBAAABBBBBBBBBBBBBBBBBBBBBBBBBBBBBBBBBAABBBBBBBBBAAAB",
"BBBBAABBBBBBBBBBBBBBBBBBBBBBBBBBBBBBBBBBBAAABBABBBBAAABB",
"BBBAAABBBBBBBBBBBBBBBBBBBBABBABBBBBBBBBBBBBAABBBBBAAABBB",
"BBBABBBBBBBBBBBBBBBBBBBBBBBBBBBBBBBBBBBBBBBBAAABAAAABBBB",
"BBAABBBBBBBBBBBBBBBBBBBBBBBBBBBBBBBBBBBBBBBBABBBAAABBBBB",
"BBBBBBBBBBBBBBBBBBBBBBBBBBBBBBBBBBBBBBBBBBBBBBAAAAABBBBB",
"BBBBBBBBBBBBBBBBBBBBBBBBBBBBBBBBBBBBBBBBBBBBBBAAABBBBBBB",
"BBBBBBBBBBBBBBBBBBBBBBBBBBBBBBBBBBBBBBBBBBBBBAAAABABABBB",
"BBBBBBBBBBBBBBBBBBBBBBBBBBBBBBBBBBBBBBBBBBBBAAABBBABBBBB",
"BBABBBBBBBBBBBBBBBBBBBBBBBBBBBBBBBBBBBBBBBBAAABBBAAABBBB",
"BBBBBBBBBBBBBBBBBBBBBBBBBBBBBBBBBBBBBBBBBBAAABBBBBBAABBB",
"BBBBABBBBBBBBBBBBBBBBBBBBBBBBBBBBABBBBBBAAAABBBBBBBBAABB",
"BBBBBBBBBBBBBBBBBBBBBBBBBBBBBBBBBBBBBBBBAAABBBBBBBBBAAAB",
"BBBBBBBBBBBBBBBBBBBBBBBBBBBBBBBBBBBBBBBAAAABBBBBBBBBBBAA",
"BBBBBBBBBBBBBBBBBBBBBBBBBBBBBBBBBBBBBAAAABBBBBBBBBBBBBBA",
"BBBBBBBBBBBBBBBBBBBBBBBBBBBBBBBBBABBAAAABBBBBBBBBBBBBBBA",
"BBBBBBBBBBBBBBBBBBBBBBBBBBBBBBBBBAAAAAAABBBBBBBBBBBBBBBB",
"BBBBBBBBBBBBBBBBBBBBBBBBBBBBBBBBAAAAAAABBBBBBBBBBBBBBBBB",
"BBBBBBBBBBBBBBBBBBBBBBBBBBBBBBBABAAAAABBBBBBBBBBBBBBBBBB",
"BBBBBBBBBBBBBBBBBBBBBBBBBBBBBBABAAAAAABBBBBBBBBBBBBBBBBB",
"BBBBBBBBBBBBBBBBBBBBBBBBBBBBBAAAAAAAAAABBBABBBBBBBBBBBBB",
"BBBBBBABBBBBBBBBBBBBBBBBBBBBAAAAAAABABBBBBBBBBBBBBBBBBBB",
"BBBBBBBBBBBBBBBBBBBBBBBBBBBAAAAAAABABBBBBBBBBBBBBBBBBBBB",
"BBBBBBBBBBBBBBBBBBBBBBBBBBAAAAAAAAABBBBBBBBBBBBBBBBBBBBB",
"BBBAABBBBBBBBBBBBABBBBBBBAAAAAAAAABBBBBBBBBBBBBBBBBABBBB",
"BBBBBBBBBBBBBBBBBBBBBBBBAAAAAAAAABBBBBBBBBBBBBBBBBBBBBBB",
"BBBBBBBBBBBBBBBBBBBBBBBAAAAAAAAABBBBBBBBBBBBBBBBBBBBBBBB",
"BBBBBBBBBBBBBBBBBBBBBBAAAAAAAAABBBBBBBBBBBBBBBBBBBBABBBB",
"BBABBBBBBBBBBBBBBBBABAAAAAAAAABBBBBBBBBBBBBBBBBBBBBBBBBB",
"BBBBBBBBBBBBBBBBBBBAAAAAAAAAABBBBBBBBBBBBBBBBBBBBBBBBBBB",
"BBBBBBBBBBBBBBBBBBBBBAAAAAAABBBBBBBBBBBBBBBBBBBBBBBBBBBB",
"BBABBBBBBBBBBBBBBBBBBAAAAAABBBBBBBBBBBBBBBBBBBBBBBBBBBBB",
"BBABBBBBBBBBBBBBBBBAAAAAAABBBBBBBBBBBBBBBBBBBBBBBBBBBBBB",
"BBBBBBBBBBBBBBBBBBBAAABBABBBBBBBBBBBBBBBBBBBBBBBBBBBBBBB",
"ABBBBBBBBBBBBBBBBAAAAABBAABBBBBBBBBBBBBBBBBBBBBBBBBBBBBB",
"AABBBBBBBBBBBBBBBAAABBBBBBBBBBBBBBBBBBBBBBBBBBBBBBBBBBBB",
"BAABBBBBBBBBBBBBAAAABBBBBBBBBABBBBBBBBBBBBBBBBBBBBBBBBBB",
"BBABBBBBBBBBBBBAAABBBBBBBBBBBBBBBBBBBBBBBBBBBBBBBBBBBBBB",
"BBBAAABBBBBBBBAAABBBBBBBBBBBBBBBBBBBBBBBBBBBBBBBBBBBBBBB",
"BBBAABBBBBBBBAAABBBBBBBBBBBBBBBBBBBBBBBBBBBBBBBBBBBBBBBB",
"BBBBBAABBBBBAAABBBBBBBBBBBBBBBBBBBBBBBBBBBBBBBBBBBBBBBBB",
"BBBBBBAAABBAAABBBBBBBBBBBBBBBBBBBBBBBBBBBBBBBBBBBBBBBBBB",
"BBBBBBBBAAAAABBBBBBBBBBBBBBBBBBBBBBBBBBBBBBBBBBBBBBBBBBB",
"BBBBBBBBAAAABBBBBBBBBBBBBBBBBBBBBBBBBBBBBBBBBBBBBBBBBBBB",
"BBBBBBBBAAAABBBBBBBBBBBBBBBBBBBBBBBBBBBBBBBBBBBBBBBBBBBA",
"BBBBBBAAAAAAABBBBBBBBBBBBBBBBBBBBBBBBBBBBBBBBBBBBBBBBBBA",
"BBBBBAAAABBBABBBBBBBBBBBBBBBBBBBBBBBBBBBBBBBBBBBBBBBBAAA",
"BBBBBAAAABBBAABBBBBBBBBBBBBBBBBBABBBBBBBBBBBBBBBBBBBBABB",
"BBBBAAAABBBBBABABBBBBBBBBBBBBBBBBBBBBBBBBBBBBBBBBBBAAABB",
"BBBAAABBBBBBBBAABBBBBBBBBBBBBABBBBBBBBBBBBABBBBBBBBAABBB",
"BBAAABBBBBBBBBAABBBBBBBBBBBBBABBBBBBBBBBBBBBBBBBBAAABBBB",
"AAAABBBBBBBBBBBBAABBBAABBABBBBBBBBBBBBBBBBBBABBBBABBBBBB",
"AAABBBBBBBBBBBBBBAABBBBBBBBBBBBBBBBBBBBBBBBBBBBBBBBBBBBB",
"AAABBBBBBBBBBBBBBBAABBBBBBBBBBBBBBBBBBBBBBBBBBBBBBBBBBBB"
